[info]
levels=40
[1]
1=22222222222222222222
2=22222222222222222222
3=22266666666622222222
4=22261111111622222222
5=22261151115622222222
6=22266661111622222222
7=22222261511662222222
8=22266661115162222222
9=22264415166166662222
10=22264411566111162222
11=22264411115111162222
12=22264666566616362222
13=22264626111116662222
14=22266626666666222222
15=22222222222222222222
16=22222222222222222222
[2]
1=22222222222222222222
2=22222222222222222222
3=66666666666666666666
4=61166666666661111136
5=61561111611111666666
6=61111116666111611666
7=66666111111111611666
8=61115111111111611666
9=61156666116111611116
10=61616116446566611616
11=61616516446115115516
12=61111116446116111616
13=61116116446116111616
14=66666666666666666666
15=22222222222222222222
16=22222222222222222222
[3]
1=22222222222222222222
2=22222222222222222222
3=66666666666666666666
4=61111111111111111666
5=61561115166115111166
6=61111566611116155166
7=64666111115151661166
8=64446116116111165116
9=64466556666151161116
10=64446111111516611666
11=64445116661161111616
12=66441156116611166316
13=66646111111111111116
14=66666666666666666666
15=22222222222222222222
16=22222222222222222222
[4]
1=22222222222222222222
2=22222222222222222222
3=66666666666666666666
4=61116111161116111636
5=61511111151115111616
6=66166644661666111116
7=61116444465611566616
8=61516444461151151516
9=61116444461616151516
10=61116644661116561116
11=66566111166116116566
12=61115115111116116116
13=61116111161116111116
14=66666666666666666666
15=22222222222222222222
16=22222222222222222222
[5]
1=22222222222222222222
2=22222222222222222222
3=66666666666666666666
4=61111366111111611166
5=61111661111511115166
6=61166644446161611666
7=61116444461616151116
8=66616444611611111116
9=66116646111115111516
10=66115151666116161666
11=66151111111616151116
12=66661511561616161516
13=66661111111116161166
14=66666666666666666666
15=22222222222222222222
16=22222222222222222222
[6]
1=22222222222222222222
2=22222222222222222222
3=66666666666666666666
4=61161166111161113666
5=66111151111615666116
6=66561516656151511116
7=61115611115111111666
8=61661115166611644446
9=61615616161616444466
10=61111515161164444666
11=66516661151644446666
12=61161511111111666666
13=61111116161111666666
14=66666666666666666666
15=22222222222222222222
16=22222222222222222222
[7]
1=22222222222222222222
2=22222222222222222222
3=66666666666666666666
4=63111116661116116116
5=61616116115115111116
6=66666111116151565616
7=64644611116651511116
8=64444411115111611166
9=64444411116665665666
10=64644611115111161116
11=66666111116116511516
12=66666116115111151516
13=66666116116116116116
14=66666666666666666666
15=22222222222222222222
16=22222222222222222222
[8]
1=22222222222222222222
2=22222222222222222222
3=66666666666666666666
4=66444111661611116116
5=64444111111111516616
6=64444616165666511116
7=64446111161111111616
8=66461165161111156616
9=61161161515166611516
10=61111151151611616616
11=66161661655615611616
12=61161115151611111166
13=61111611111611611136
14=66666666666666666666
15=22222222222222222222
16=22222222222222222222
[9]
1=22222222222222222222
2=22222222222222222222
3=66666666666666666666
4=61116116361661166666
5=61616115111151166666
6=61611116666661511666
7=61116116444461155116
8=66566566444461111116
9=61111116444466566566
10=61155116444461111116
11=61511511611611666116
12=66666115111511115116
13=66666161111611611166
14=66666666666666666666
15=22222222222222222222
16=22222222222222222222
[10]
1=22222222222222222222
2=22222222222222222222
3=66666666666666666666
4=61611111611111111116
5=61111111511661666166
6=66666116611151151116
7=66446611616151616116
8=64444115111116656166
9=64444115666661116566
10=66446161161116115116
11=66646161151115116136
12=66115115161116116666
13=66111111166666666666
14=66666666666666666666
15=22222222222222222222
16=22222222222222222222
[11]
1=22222222222222222222
2=22222222222222222222
3=66666666666666666666
4=61111166644666111116
5=61551166644666115316
6=61161664444446115116
7=61111164444446115116
8=66661166644666666516
9=61115551644611116116
10=61561115115115516516
11=61161166151166116116
12=61511115166151111516
13=61161166111166116116
14=66666666666666666666
15=22222222222222222222
16=22222222222222222222
[12]
1=22222222222222222222
2=22222222222222222222
3=66666666666666666666
4=61111611616116116116
5=61361616615111511166
6=66661611116116151116
7=61111616616516616616
8=61111115111511151116
9=64466655661566516616
10=64464611615111516116
11=64444615511166516666
12=64444611666661111116
13=64446661111111166116
14=66666666666666666666
15=22222222222222222222
16=22222222222222222222
[13]
1=22222222222222222222
2=22222222222222222222
3=66666666666666666666
4=64444611111116116116
5=64444616151151111116
6=64444166115616156516
7=64446111511156115116
8=64466661161511155116
9=61111116666166661666
10=61111111161116111116
11=61661116111516151516
12=61661111516615115116
13=61111136111116111616
14=66666666666666666666
15=22222222222222222222
16=22222222222222222222
[14]
1=22222222222222222222
2=22222222222222222222
3=66666666666666666666
4=64444666111111111116
5=64444666661611656166
6=64444666111651151116
7=64444666111151165566
8=66116666156116515116
9=66116666115115116116
10=63116666566656615116
11=66111111116116115116
12=66111666116115116666
13=66666666116116111116
14=66666666666666666666
15=22222222222222222222
16=22222222222222222222
[15]
1=22222222222222222222
2=22222222222222222222
3=66666666666666666666
4=61111161111136444666
5=61111161111116644466
6=61616166566166144446
7=61115161115551144446
8=66656661551166616646
9=61111151161111616666
10=61151161166611616116
11=66165661111511551116
12=61115166111611616116
13=61111161111611611116
14=66666666666666666666
15=22222222222222222222
16=22222222222222222222
[16]
1=22222222222222222222
2=22222222222222222222
3=66666666666666666666
4=61111161164446311116
5=61611111114444611116
6=61151161116444461116
7=61665666616644446116
8=61511151161164446116
9=61551611161116155116
10=66611555611155115116
11=61511611611116156116
12=61115611611111115116
13=61161111611116116116
14=66666666666666666666
15=22222222222222222222
16=22222222222222222222
[17]
1=22222222222222222222
2=22222222222222222222
3=66666666666666666666
4=66666366646644466116
5=66666511446444611116
6=66661111444444611516
7=66611516444446616166
8=66115561666661151516
9=66156151111661155116
10=66116116111161511516
11=66111551666165661116
12=66156111111515115166
13=66611116111161111666
14=66666666666666666666
15=22222222222222222222
16=22222222222222222222
[18]
1=22222222222222222222
2=22222222222222222222
3=66666666666666666666
4=63111116111611111116
5=66166616611666616166
6=61111616115511111116
7=61161616151615166166
8=61111151611655161116
9=61166611611111166166
10=64464615161151611116
11=64464611516166155116
12=64444661115511511616
13=64444466111111116116
14=66666666666666666666
15=22222222222222222222
16=22222222222222222222
[19]
1=22222222222222222222
2=22222222222222222222
3=66666666666666666666
4=61161111116111611166
5=61561515166444511516
6=61151161664444615116
7=61661516644446111516
8=61511116444466151116
9=61566116444611111116
10=61115556656611666166
11=61616116111611611116
12=61516115116611111116
13=61111611116311111116
14=66666666666666666666
15=22222222222222222222
16=22222222222222222222
[20]
1=22222222222222222222
2=22222222222222222222
3=66666666666666666666
4=61161161611116116116
5=61115111111515111116
6=66161165666566116616
7=61115111115116115116
8=61666566561116151116
9=61611151511666666156
10=61511551511636464446
11=61611111611616464446
12=61666666666616444446
13=61111111111116444446
14=66666666666666666666
15=22222222222222222222
16=22222222222222222222
[21]
1=22222222222222222222
2=22222222222222222222
3=66666666666666666666
4=61161111161166111166
5=61561115161111166116
6=61511511644611111516
7=61515116444461116166
8=61561164444446661516
9=61116116444461165116
10=61511666644611161116
11=66151116616161511566
12=66615111156351561116
13=66661116111111161116
14=66666666666666666666
15=22222222222222222222
16=22222222222222222222
[22]
1=22222222222222222222
2=22222222222222222222
3=66666666666666666666
4=61111114444611116666
5=61111114444111111116
6=61616666666666111116
7=61651116111111666446
8=61151116556661116446
9=61516661511151116446
10=61516111515161166446
11=61161155161516611166
12=63661561151151111166
13=66111111166111611666
14=66666666666666666666
15=22222222222222222222
16=22222222222222222222
[23]
1=22222222222222222222
2=22222222222222222222
3=66666666666666666666
4=61111111161116316116
5=61551165561616116616
6=61161515165516111116
7=66161161161616116116
8=61116611111116111116
9=61116151611161116116
10=61516516111611516446
11=66516116666111164446
12=61151111111111644446
13=61116116111116444446
14=66666666666666666666
15=22222222222222222222
16=22222222222222222222
[24]
1=22222222222222222222
2=22222222222222222222
3=66666666666666666666
4=61111161116666611116
5=66151161116666115116
6=66661551116446116116
7=61151151166446666166
8=61511166644441115516
9=61165611144446161516
10=61611615144666561116
11=61611151644611166116
12=61115611666611161566
13=61611611113611111166
14=66666666666666666666
15=22222222222222222222
16=22222222222222222222
[25]
1=22222222222222222222
2=22222222222222222222
3=66666666666666666666
4=61116111611116111636
5=61115115111116151616
6=66561566616111155616
7=61161164666116515116
8=61165644446116166616
9=61511644444661111616
10=66511646444465515116
11=61166666644661611616
12=61151111111115166616
13=61116111611111111616
14=66666666666666666666
15=22222222222222222222
16=22222222222222222222
[26]
1=22222222222222222222
2=22222222222222222222
3=66666666666666666666
4=61616161116366111616
5=61111111111111511116
6=61166561666661516166
7=66111166444446116116
8=66566564444466656516
9=61116166444446116166
10=61151111664466116116
11=61516115111151155516
12=66151156161161151116
13=61116611161161111116
14=66666666666666666666
15=22222222222222222222
16=22222222222222222222
[27]
1=22222222222222222222
2=22222222222222222222
3=22266666622666662222
4=22261111622611162222
5=22261511666615162222
6=22261511111151162222
7=22261166636665162222
8=22266666666661666222
9=22264411166111116222
10=22264411166511116222
11=22264411166151116222
12=22264411166151116222
13=22264411111515116222
14=22266611666666666222
15=22222666622222222222
16=22222222222222222222
[28]
1=22222222222222222222
2=22222222222222222222
3=22222226666666666622
4=22222226111111111622
5=22222226111151511622
6=66666626151666661622
7=61111666661511665622
8=61111111515111111622
9=61111111111661661622
10=61111663666661661622
11=61111666622261661662
12=64444622222261511162
13=64444622222261111162
14=66666622222266666662
15=22222222222222222222
16=22222222222222222222
[29]
1=22222222222222222222
2=22222222222222222222
3=66666666666662222222
4=61111111111162222222
5=61666155111162222222
6=61116151151162222222
7=61156666566666622222
8=61516611111111666662
9=61155151111111144462
10=66616615561111144462
11=22616611161111144462
12=22611111161111144462
13=22666366666666666662
14=22226662222222222222
15=22222222222222222222
16=22222222222222222222
[30]
1=22222222222222222222
2=22222222222222222222
3=22666666666666666662
4=66636611111111144462
5=61111611111111144462
6=61511611111111144462
7=61551611111111144462
8=66151666566666666662
9=26166611516222222222
10=66111511516222222222
11=61151611516222222222
12=61511611116222222222
13=61151611116222222222
14=61111611116222222222
15=66666666666222222222
16=22222222222222222222
[31]
1=22222222222222222222
2=22222222222222222222
3=22222222222222666662
4=22222666666666611162
5=22222611111111611162
6=22222611515111155162
7=22222616666616615162
8=22222655111656615162
9=22222616661616651162
10=66666616661515111162
11=64444111111116611162
12=64444111111116666662
13=64444111111116222222
14=66666666666366222222
15=22222222226662222222
16=22222222222222222222
[32]
1=22222222222222222222
2=22222222222222222222
3=22222666666222222222
4=22666611116222222222
5=22611116616222222222
6=22615111116222222222
7=26661666616666666622
8=26115111516611444622
9=26111551551111444622
10=26111151156611444622
11=26636616616611444622
12=22666115116666666622
13=22611155116222222222
14=22611116116222222222
15=22666666666222222222
16=22222222222222222222
[33]
1=22222222222222222222
2=22222222222222222222
3=26666666266666666622
4=26111116261116611622
5=26166616261115111622
6=26161516661115111622
7=26111551111116651622
8=26111166661116611622
9=26366666666666616622
10=26664411116666651622
11=22264411116666111622
12=22264411111115511622
13=22264411116666151622
14=22264411116226111622
15=22266666666226666622
16=22222222222222222222
[34]
1=22222222222222222222
2=22222222222222222222
3=22666666622222222222
4=22611111666666666622
5=22611111611116116622
6=22615111611151511622
7=22611511611516611622
8=22615511665151111622
9=22661611661666666622
10=22661611661111444622
11=22611651111111444622
12=22611155111111444622
13=22611111663611444622
14=22666666666666666622
15=22222222222222222222
16=22222222222222222222
[35]
1=66666666666622222222
2=61111116111662222222
3=61511511161166666622
4=66661166666111111622
5=26441161111166661622
6=26466661166661111622
7=26444411116115166662
8=26144461116155561166
9=66646666166115351116
10=61111166666151611116
11=61646151111115666516
12=61646666666611611516
13=61644111111116611516
14=61616666666151616116
15=61116222226111111166
16=66666222226666666666
[36]
1=22222222222222222222
2=22222222222222222222
3=22222222222222222222
4=26666666666666666222
5=26111111163161116222
6=26161616161511556222
7=26164446165551116222
8=26114446161511556622
9=26166466161661111622
10=26164441111151111622
11=26166166611666666622
12=26111162666622222222
13=26666662222222222222
14=22222222222222222222
15=22222222222222222222
16=22222222222222222222
[37]
1=22222222222222222222
2=22222266666222222222
3=22266661116626666622
4=22261151111666111622
5=22261535151111511622
6=22261656666666616622
7=22261611511611111622
8=22261615151616111622
9=22661611561616666622
10=22611661111611111622
11=22611115161666111622
12=22666661661164444622
13=22611115111114444622
14=22611111111164444622
15=22666666666666666622
16=22222222222222222222
[38]
1=26666666666666222222
2=26444444446666222222
3=26444666616116666622
4=26444611666111151622
5=26444551111151511622
6=26114611515615116622
7=26444616561115116222
8=26461615111511116222
9=26411656665666656222
10=26611611151511116222
11=22611611535116116222
12=22611616666151156222
13=22611611116661116222
14=22611615516266666222
15=22611611116222222222
16=22666666666222222222
[39]
1=22222222222222222222
2=22222222222222222222
3=26666622222226662222
4=26116666666666666662
5=26151117131711611162
6=26116171717171111162
7=26616117141711616662
8=22616171717171616222
9=22616117141711616222
10=22616171717171616222
11=26616117141711616622
12=26616666666666611622
13=26151111111111151622
14=26111666666666611622
15=26666622222222666622
16=22222222222222222222
[40]
1=66666666666666666666
2=64461111611111111116
3=64511511655115661566
4=64561166611661661116
5=61161516115511151116
6=61666116161165116666
7=61166161511163161116
8=61511115116646611516
9=61161561561511111666
10=61161161161116661116
11=61166666666161111116
12=61111111111161164646
13=66566666666561114446
14=61111471161111664646
15=61474447111511444446
16=66666666666666666666
