[info]
levels=50

[1]
1=22222222222222222222
2=22222222222222222222
3=22222222222222222222
4=22226666622222222222
5=22226111622222222222
6=22226511622222222222
7=22666115662222222222
8=22611515162222222222
9=66616166162226666662
10=61116166166666114462
11=61511511111111114462
12=66666166616366114462
13=22226111116666666662
14=22226666666222222222
15=22222222222222222222
16=22222222222222222222
[2]
1=22222222222222222222
2=22222222222222222222
3=22222222222222222222
4=22266666666666622222
5=22264411611111666222
6=22264411615115116222
7=22264411656666116222
8=22264411113166116222
9=22264411616115166222
10=22266666616651516222
11=22222615115151516222
12=22222611116111116222
13=22222666666666666222
14=22222222222222222222
15=22222222222222222222
16=22222222222222222222
[3]
1=22222222222222222222
2=22222222222222222222
3=22222222222222222222
4=22222222226666666622
5=22222222226111113622
6=22222222226156516622
7=22222222226151156222
8=22222222226651516222
9=22666666666151616662
10=22644441166151151162
11=22664441111511511162
12=22644441166666666662
13=22666666662222222222
14=22222222222222222222
15=22222222222222222222
16=22222222222222222222
[4]
1=22222222222222222222
2=22222222222666666662
3=22222222222611444462
4=66666666666611444462
5=61111611515111444462
6=61555651151611444462
7=61151111151611444462
8=61551651515666666662
9=61151611111622222222
10=66166666666622222222
11=61111611116222222222
12=61111151116622222222
13=61155655113622222222
14=61111611116622222222
15=66666666666222222222
16=22222222222222222222
[5]
1=22222222222222222222
2=22222222222222222222
3=22222222222222222222
4=22222222226666622222
5=22222222226111666662
6=22222222226165661162
7=22222222226111115162
8=22666666666166611162
9=22644441166151156662
10=22644441111515516622
11=22644441166511513622
12=22666666666115116622
13=22222222226151511622
14=22222222226661661622
15=22222222222261111622
16=22222222222266666622
[6]
1=22222222222222222222
2=22222222222222222222
3=22222222222222222222
4=22266666622666222222
5=22264411626636622222
6=22264411666111622222
7=22264411111551622222
8=22264411616151622222
9=22264466616151622222
10=22266661516511622222
11=22222261156151622222
12=22222261511511622222
13=22222261166111622222
14=22222266666666622222
15=22222222222222222222
16=22222222222222222222
[7]
1=22222222222222222222
2=22222222222222222222
3=22222222226666622222
4=22226666666111662222
5=22266161366155162222
6=22261111511111162222
7=22261151166611162222
8=22266616666656662222
9=22261511666144622222
10=22261515151444622222
11=22261111666444622222
12=22261551626444622222
13=22261166626666622222
14=22266662222222222222
15=22222222222222222222
16=22222222222222222222
[8]
1=22266662222222222222
2=22261166666666666222
3=22261111511151516222
4=22261561516115116222
5=22261151511611116222
6=26661561611666616222
7=26365151511661116222
8=26111151656111616222
9=26111511115151516222
10=26666611666666666222
11=22261111116222222222
12=22261111116222222222
13=22264444446222222222
14=22264444446222222222
15=22264444446222222222
16=22266666666222222222
[9]
1=22222222222222222222
2=22222222222266666662
3=22222222222261144462
4=22222222666661144462
5=22222222611111141462
6=22222222611661144462
7=22222222661661144462
8=22222226661666666662
9=22222226155516622222
10=22266666115151666662
11=22661116515111611162
12=22631511511115115162
13=22666666155151666662
14=22222226111111622222
15=22222226666666622222
16=22222222222222222222
[10]
1=26662266666666666662
2=66366661111111611162
3=61551115511515144462
4=61155561111511644462
5=61511161551551644462
6=66611161151111644462
7=61111161515151644462
8=61111666666166644462
9=66161161151511644462
10=61166161551515664462
11=61446161151111116462
12=61446161555155516462
13=66666161111111616462
14=22226166666666616462
15=22226111111111116462
16=22226666666666666662
[11]
1=22222222222666622222
2=22222266662611622222
3=22226661366651622222
4=22266111111511622222
5=22661151556616622222
6=22611656611111622222
7=22616151551616662222
8=22611151611615166666
9=22666111161155161116
10=26666166151111111116
11=26411116661166666666
12=26441446266662222222
13=26444646222222222222
14=26444446222222222222
15=26666666222222222222
16=22222222222222222222
[12]
1=22222222222222222222
2=22222222222222222222
3=26666666666666666222
4=26111111111111116222
5=26161666666111116222
6=26161151515156116222
7=26161115351116616622
8=26161151515666444622
9=26161115151166444622
10=26166655515166444622
11=26111116166166444622
12=26666611166166444622
13=22222666661111166622
14=22222222261111162222
15=22222222266666662222
16=22222222222222222222
[13]
1=22222222222222222222
2=22222222222222222222
3=22266666666622222222
4=22661116611666666222
5=66611111611611116662
6=61151651611611444162
7=61615635661616464162
8=61161651161111414162
9=61511115161616464162
10=61116611665151414162
11=61516111611656464162
12=66151151115115444162
13=26516666661111661162
14=26116222266666666662
15=26666222222222222222
16=22222222222222222222
[14]
1=22222222666666622222
2=22666666611111622222
3=22611111615351622222
4=22655161116666666662
5=22616664444446611162
6=22611154444446616162
7=22616664444441111162
8=26611166661666165662
9=26116511161151161622
10=26115155511615661622
11=26111515166655161622
12=26666611111511161622
13=22222666166611161622
14=22222226111116111622
15=22222226666666611622
16=22222222222222666622
[15]
1=22226666666622222222
2=22226111611622222222
3=22226115111622222222
4=22666165111666622222
5=22611511665111622222
6=22611613151615622222
7=22611611111151666622
8=22661666656611111622
9=22615644444616111622
10=22611544774156166622
11=26611644444611162222
12=26111666166666662222
13=26155116116222222222
14=26116111116222222222
15=26666661116222222222
16=22222266666222222222
[16]
1=22222222222222222222
2=22266666222222222222
3=22261116622222222222
4=22261111622666622222
5=22261511666611622222
6=22261155151115622222
7=22266631651111662222
8=22226116611515166222
9=22226151166166146222
10=22226116566511646222
11=22226661115446646222
12=22222611116474446222
13=22222615516444446222
14=22222611666666666222
15=22222611622222222222
16=22222666622222222222
[17]
1=22222222222222222222
2=22222666666666622222
3=22222644116111622222
4=22222644111111622222
5=22222644116116666222
6=22226666666116116622
7=22226111111111111622
8=22226116116611611622
9=22666616611666616622
10=22611511666661611622
11=22616151151161511622
12=22613511511161116622
13=22666616616666666222
14=22222611116222222222
15=22222666666222222222
16=22222222222222222222
[18]
1=22222222222222222222
2=22222222222222222222
3=22222666666666662222
4=22222611411611162222
5=22222616411113162222
6=26666616644616666222
7=66116144666111116662
8=61516444111516115162
9=61111441661166166162
10=66665665615161116162
11=22661611116515516162
12=22611516161161566162
13=22611111111111111162
14=22611666666666661162
15=22666622222222266662
16=22222222222222222222
[19]
1=22666666222222222222
2=22611136666222222222
3=66666151116222222222
4=61116611116666222222
5=61516116611116222222
6=61516116666616222222
7=66151151111616222222
8=66151516661616222222
9=66161151161616222222
10=66161656111616222222
11=66166611161616666662
12=61151166661616444462
13=61111511115111446462
14=66665115615111444462
15=61111111611661444462
16=66666666666666666662
[20]
1=22226666666666222222
2=66666111111116666222
3=61111161115116316222
4=61666666656666116662
5=61611116616116514462
6=61615111116116116462
7=61615116111116514462
8=61611666166111116462
9=61666116116116514462
10=61611116116666116462
11=61651115115116514462
12=61111516151516116462
13=66661566611116514462
14=22261111551666444462
15=22261111116626666662
16=22266666666222222222
[21]
1=22222222222222222222
2=22666666666222222222
3=22611111116222222222
4=22611111116666222222
5=22661666616116222222
6=22661636611116222222
7=22615551511556222222
8=22611616615116222222
9=22611616611516666222
10=22666611555156116222
11=22261116611144446222
12=22261611161644146222
13=22261116161664446222
14=22266666151164446222
15=22222226611166666222
16=22222222666662222222
[22]
1=66666622222666622222
2=61111666666611666662
3=61115611611511611162
4=61151151151615151162
5=66515111613615111162
6=61151666666666661662
7=61611164444444615622
8=61661161444444611622
9=61611154444444451622
10=61615164444144611622
11=61151566665666615622
12=61511166615111511662
13=61511111515115111162
14=66166666615166666162
15=61111111116111111162
16=66666666666666666662
[23]
1=22222222222222222222
2=22226666666222222222
3=22226116116666222222
4=66666156516116622222
5=64416116116111622222
6=64416156516115666622
7=64116111116511611622
8=64411156116151111622
9=64436116516511611622
10=64416156111115611622
11=64416116556511611662
12=64416156116115651162
13=64416116116111611162
14=66416666116666611162
15=26666226666222666662
16=22222222222222222222
[24]
1=66666666666666622222
2=64444444444114666622
3=64444444444554611622
4=66666666666516111662
5=61111115115111115162
6=66166661116115161162
7=61111116111661161662
8=61156116166116661662
9=61516566611116661662
10=66611516116116661662
11=66611115166161161662
12=26151161151151511162
13=26115115655511611162
14=26116115111111666662
15=26136611611611622222
16=26666666666666622222
[25]
1=66662222222222222222
2=61166666666666666222
3=61161114464444446222
4=61161616666614446222
5=66561111444444446222
6=61116656666661166662
7=61516111116666663162
8=66516151116666661162
9=61151655566111111162
10=61111116111165656662
11=61666616555551111622
12=61611115111116111622
13=61611166111111116662
14=61666666566666615162
15=61111111162222611162
16=66666666662222666662
[26]
1=22222222222222222222
2=22222222222222222222
3=22222222222222222222
4=22222222222222222222
5=22666666622222222222
6=22611611666662222222
7=26611611644466622222
8=26115611644411622222
9=26151655144411622222
10=26115611644414622222
11=26111615666666662222
12=26651111111515162222
13=26611611551611162222
14=22666666116655362222
15=22222226111111662222
16=22222226666666622222
[27]
1=22222222222222222222
2=26666666666666666622
3=26444111611116111662
4=66444441156616165162
5=64444446115116111162
6=64444446116116161162
7=66666666615115151162
8=22611111656651665662
9=26611151111611111162
10=26116616661611665162
11=26151551111151151162
12=26151111566516666662
13=26666666113166222222
14=22222226666662222222
15=22222222222222222222
16=22222222222222222222
[28]
1=22222222222222222222
2=22222222222666662222
3=22222226666611162222
4=22222266151151166662
5=22666661511515166462
6=22611111115511664462
7=22611666666166644162
8=22661611611116444162
9=22615111611116444162
10=22631651661666644462
11=22666611515511664462
12=22222661151511544462
13=22222261551151611462
14=22222261115151166662
15=22222266666611162222
16=22222222222666662222
[29]
1=22222222222222222222
2=22222222222222222222
3=66666222222222222222
4=61116622222222222222
5=61511666666666222222
6=66161611111116666662
7=66161115656311611162
8=61161111115161115162
9=61166616666666661662
10=61166144744444161662
11=66166174744747161662
12=61566666666661665162
13=61151115115111151162
14=61161116111611161162
15=66666666666666666662
16=22222222222222222222
[30]
1=22222222222222222222
2=22222222666666666662
3=22222222611161111162
4=26666622611111515162
5=26111666661566161662
6=26151661116166151162
7=26151135516166555162
8=26616661116166111162
9=26616111666166666562
10=26616111115116444462
11=26116661661516444466
12=26151115161116445416
13=26116615161166444416
14=26666611166666644466
15=22222666662222666662
16=22222222222222222222
[31]
1=22266662222222222222
2=22261166666666622222
3=22661166116111622222
4=22611561535111666622
5=22651151161515611662
6=26611566165151111162
7=26116116161115551162
8=26151111511566166662
9=26151516561161162222
10=26611666116665162222
11=22611644441111162222
12=22666644444466662222
13=22226444466662222222
14=22226444662222222222
15=22226444622222222222
16=22226666622222222222
[32]
1=22222222222222222222
2=22222222266662222222
3=22222666661162222222
4=22226611111562222222
5=22266151166166622222
6=22263515161511622222
7=22266661661115622222
8=22226444465151622222
9=22226444461115622222
10=22226444411551662222
11=22226444161511162222
12=22226666665151162222
13=22222222261116662222
14=22222222265166622222
15=22222222261162222222
16=22222222266662222222
[33]
1=22226666666666662222
2=22226611111661162222
3=22226611151115162222
4=22226666166155162222
5=22226111516111162222
6=22226155516166662222
7=22226111616151662222
8=22226116116115162222
9=22226156156111162222
10=22226111446166662222
11=22226666441516362222
12=22226444446156162222
13=22226644446115162222
14=22226664466111162222
15=22226666666666662222
16=22222222222222222222
[34]
1=22226666666662222222
2=22226444411166222222
3=22226464611516622222
4=22266444461613662222
5=22261444461161166222
6=22261111165166516222
7=22266166611511116222
8=22226511515156116222
9=22226161151516616222
10=22226116661166116222
11=22226111166166166222
12=22226115161151162222
13=22226665151116662222
14=22222261166666222222
15=22222266662222222222
16=22222222222222222222
[35]
1=66666666666626666662
2=61116111161666444462
3=61115561113114444462
4=61116166611161444462
5=66166166611611444462
6=26151511111616166662
7=26115156611611111162
8=66661611666616166162
9=61161651116616111162
10=61511511616616111662
11=61615151111616111622
12=61151661661616666622
13=61551111155116222222
14=66166166615116222222
15=26111162611116222222
16=26666662666666222222
[36]
1=22222222222266666222
2=66666226666661116222
3=61116666115151516222
4=61511166166166116622
5=61115151111151151622
6=66615116616611111662
7=22616666616666655162
8=26656666613661111162
9=26151166656661511662
10=26151161116661166622
11=26155151611155162222
12=26111116111661162222
13=26666666441466662222
14=22226444444444622222
15=22226444444444622222
16=22226666666666622222
[37]
1=66666666666222222222
2=64444441116666666662
3=64444441116116611162
4=64466615111151111162
5=64441515161116611162
6=64446566666111161162
7=66611116111651165162
8=22611111515115661162
9=22611111165651665162
10=22666166161111661162
11=22261151516616666662
12=22261111511511622222
13=22266111616111622222
14=22226666636666622222
15=22222222666222222222
16=22222222222222222222
[38]
1=22222222222222222222
2=22222222222222222222
3=22222222222222222222
4=22222222226666222222
5=22226666666136222222
6=22226111115116222222
7=22226111566156222222
8=22226656444616222222
9=22222615444116222222
10=22222616414616622222
11=22222611161651622222
12=22222651151111622222
13=22222611666666622222
14=22222666622222222222
15=22222222222222222222
16=22222222222222222222
[39]
1=22222222222226666662
2=26666666666666444462
3=66111661111166444462
4=61155661151366444462
5=61111115515611444462
6=61151661551616144462
7=61151661511611444462
8=66166666166616646662
9=66111511516611141162
10=61566611616666616662
11=61115111611111116222
12=61151651515666116222
13=61555615111626666222
14=61111611551622222222
15=66666611166622222222
16=22222666662222222222
[40]
1=22222266666666666622
2=22222261111111111662
3=22222261161655151162
4=22222265165611661362
5=22222661661615161662
6=22222611151651161622
7=22222611161511161622
8=22222661515111661622
9=22222611611661151622
10=22222611116615561622
11=22666666551116111622
12=22644446116666666622
13=22646444166222222222
14=22644441116222222222
15=22644441116222222222
16=22666666666222222222
[41]
1=22222222222222222222
2=22222222222666662222
3=22222222226611166222
4=22222222266111116222
5=22222222661155116222
6=22222226615511516222
7=22222226151111516222
8=66662226111551666662
9=61166666666166111162
10=64111111111111555362
11=64616666666166111662
12=64616666666416515662
13=64444444444416111162
14=66666666666666115162
15=22222222222226611662
16=22222222222222666622
[42]
1=22222222222222222222
2=22222222222222222222
3=22222266666666222222
4=22266661111116666662
5=22261111661515111362
6=22261661665651515662
7=26661444444611551662
8=26111444444611611162
9=26161444444651151162
10=26165444444155615162
11=26111666166651151662
12=26661151151151151622
13=22261151151151151622
14=22266666611166666622
15=22222222666662222222
16=22222222222222222222
[43]
1=22222222222222222222
2=22222222222222222222
3=22222222222222222222
4=22222222666666622222
5=22226666611611666622
6=22226111611151111622
7=26666165516616611622
8=66111111616116616662
9=61166615651151151162
10=64441111616611611162
11=64446111131616661662
12=64446116661151151162
13=66666666266111611162
14=22222222226666666662
15=22222222222222222222
16=22222222222222222222
[44]
1=22222222222222222222
2=26666622222222222222
3=26111622222222222222
4=26161666666622222222
5=26111111536666662222
6=26151665166611162222
7=26166661511115162222
8=26166666161165166662
9=66116666166511111162
10=61156115116166166162
11=61111111116164446162
12=66666611666114441162
13=22222666626164446162
14=22222222226166616162
15=22222222226111111162
16=22222222226666666662
[45]
1=22222222222222222222
2=22666662666622222222
3=22644462611666622222
4=22644466611511622222
5=22644446615115666222
6=22664444661115116222
7=22666444166151516222
8=22616611116115116222
9=22611661616661666622
10=22615161651151111622
11=22611513151111511622
12=22611161515515166622
13=22611666666116662222
14=22616622226666222222
15=22666222222222222222
16=22222222222222222222
[46]
1=22266666666662222222
2=22261111111166662222
3=22261666666161166222
4=22261615151511516222
5=22261111111651116222
6=22266651155611666222
7=22222611661615662222
8=22222665611151362222
9=22222261151516662222
10=22222261611151162222
11=22222261661116162222
12=22222661166666162222
13=22222611111111162222
14=22222644444446662222
15=22222644444446222222
16=22222666666666222222
[47]
1=22222222222222222222
2=22222222222222222222
3=22222222222222222222
4=22222222226666222222
5=22666666666116622222
6=26611511111151666662
7=26111661661116644462
8=26165515155656644462
9=26161113111611144462
10=26115616665511144462
11=26151155115166444462
12=26665111111166666662
13=22261166666662222222
14=22266662222222222222
15=22222222222222222222
16=22222222222222222222
[48]
1=22222666666666222222
2=22222674767476222222
3=22222647474746222222
4=22222674747476222222
5=22222647474746222222
6=22222674747476222222
7=22222666111666222222
8=22222226111622222222
9=22266666616666662222
10=22261111111111162222
11=22261515151515162222
12=22266151515151662222
13=22226515151515622222
14=22226111535111622222
15=22226116666611622222
16=22226666222666622222
[49]
1=22222222266662222222
2=22222222261166222222
3=22222222261116622222
4=22222222261551662222
5=22222226665115166222
6=22226666111151116222
7=22666116166666116222
8=22611116164444516222
9=22616111514444616222
10=22611516164744616222
11=22666116666166616222
12=22226666135116656622
13=22222226661511111622
14=22222222261166111622
15=22222222266666666622
16=22222222222222222222
[50]
1=22222266666666666622
2=22222664411116111622
3=22226644715111151622
4=22266447461616156622
5=22264474616161511622
6=66664446116111161622
7=61166161111111111622
8=61351516661161116622
9=61511151116161116222
10=66655111616161616222
11=22611151116161666662
12=22615616666611111162
13=22651116222611116162
14=22611666222661111162
15=22611622222261111662
16=22666622222266666622
