[info]
levels=78

[1]
1=22222222222222222222
2=22222222222222222222
3=22222222222222222222
4=22222222222222222222
5=22222222222222222222
6=22222226666622222222
7=22222226311662222222
8=22222226457162222222
9=22222226116162222222
10=22222226111162222222
11=22222226666662222222
12=22222222222222222222
13=22222222222222222222
14=22222222222222222222
15=22222222222222222222
16=22222222222222222222
[2]
1=22222222222222222222
2=22222222222222222222
3=22222222222222222222
4=22222222222222222222
5=22222222222222222222
6=22222266666622222222
7=22222263111662222222
8=22222261551162222222
9=22222261641462222222
10=22222261111162222222
11=22222266666662222222
12=22222222222222222222
13=22222222222222222222
14=22222222222222222222
15=22222222222222222222
16=22222222222222222222
[3]
1=22222222222222222222
2=22222222222222222222
3=22222222222222222222
4=22222222222222222222
5=22222222222222222222
6=22222222666622222222
7=22222266611622222222
8=22222263145662222222
9=22222261115162222222
10=22222261641162222222
11=22222261111162222222
12=22222266666662222222
13=22222222222222222222
14=22222222222222222222
15=22222222222222222222
16=22222222222222222222
[4]
1=22222222222222222222
2=22222222222222222222
3=22222222222222222222
4=22222222222222222222
5=22222222222222222222
6=22222226666622222222
7=22222266311662222222
8=22222261161162222222
9=22222261575162222222
10=22222261141162222222
11=22222266141662222222
12=22222226666622222222
13=22222222222222222222
14=22222222222222222222
15=22222222222222222222
16=22222222222222222222
[5]
1=22222222222222222222
2=22222222222222222222
3=22222222222222222222
4=22222222222222222222
5=22222222222222222222
6=22222266666622222222
7=22222261111666222222
8=22222261114416222222
9=22222261555316222222
10=22222261161416222222
11=22222266666666222222
12=22222222222222222222
13=22222222222222222222
14=22222222222222222222
15=22222222222222222222
16=22222222222222222222
[6]
1=22222222222222222222
2=22222222222222222222
3=22222222222222222222
4=22222222222222222222
5=22222222222222222222
6=22222226666622222222
7=22222266111666222222
8=22222261461536222222
9=22222261161616222222
10=22222261711546222222
11=22222261111666222222
12=22222266666622222222
13=22222222222222222222
14=22222222222222222222
15=22222222222222222222
16=22222222222222222222
[7]
1=22222222222222222222
2=22222222222222222222
3=22222222222222222222
4=22222222222222222222
5=22222222222222222222
6=22222266666662222222
7=22222263711662222222
8=22222261561162222222
9=22222261514162222222
10=22222264111662222222
11=22222266666662222222
12=22222222222222222222
13=22222222222222222222
14=22222222222222222222
15=22222222222222222222
16=22222222222222222222
[8]
1=22222222222222222222
2=22222222222222222222
3=22222222222222222222
4=22222222222222222222
5=22222222222222222222
6=22222266666666222222
7=22222266111166222222
8=22222261441116222222
9=22222261615556222222
10=22222261116346222222
11=22222266666666222222
12=22222222222222222222
13=22222222222222222222
14=22222222222222222222
15=22222222222222222222
16=22222222222222222222
[9]
1=22222222222222222222
2=22222222222222222222
3=22222222222222222222
4=22222222222222222222
5=22222222222222222222
6=22222266666662222222
7=22222264371662222222
8=22222265115162222222
9=22222261116162222222
10=22222261141162222222
11=22222266666662222222
12=22222222222222222222
13=22222222222222222222
14=22222222222222222222
15=22222222222222222222
16=22222222222222222222
[10]
1=22222222222222222222
2=22222222222222222222
3=22222222222222222222
4=22222222222222222222
5=22222222222222222222
6=22222266666662222222
7=22222263144662222222
8=22222261651662222222
9=22222261611162222222
10=22222261156162222222
11=22222261171162222222
12=22222266666662222222
13=22222222222222222222
14=22222222222222222222
15=22222222222222222222
16=22222222222222222222
[11]
1=22222222222222222222
2=22222222222222222222
3=22222222222222222222
4=22222222222222222222
5=22222222222222222222
6=22222266666222222222
7=22222261116222222222
8=22222261616662222222
9=22222267451162222222
10=22222261165162222222
11=22222261311462222222
12=22222266666662222222
13=22222222222222222222
14=22222222222222222222
15=22222222222222222222
16=22222222222222222222
[12]
1=22222222222222222222
2=22222222222222222222
3=22222222222222222222
4=22222222222222222222
5=22222222222222222222
6=22222266666662222222
7=22222266611362222222
8=22222264176162222222
9=22222261115162222222
10=22222261541662222222
11=22222266666662222222
12=22222222222222222222
13=22222222222222222222
14=22222222222222222222
15=22222222222222222222
16=22222222222222222222
[13]
1=22222222222222222222
2=22222222222222222222
3=22222222222222222222
4=22222222222222222222
5=22222222222222222222
6=22222266666622222222
7=22222263111662222222
8=22222261457166222222
9=22222261654116222222
10=22222261111116222222
11=22222266666666222222
12=22222222222222222222
13=22222222222222222222
14=22222222222222222222
15=22222222222222222222
16=22222222222222222222
[14]
1=22222222222222222222
2=22222222222222222222
3=22222222222222222222
4=22222222222222222222
5=22222222222222222222
6=22222266666622222222
7=22222261141622222222
8=22222261641662222222
9=22222261141162222222
10=22222261555162222222
11=22222261161362222222
12=22222266666662222222
13=22222222222222222222
14=22222222222222222222
15=22222222222222222222
16=22222222222222222222
[15]
1=22222222222222222222
2=22222222222222222222
3=22222222222222222222
4=22222222222222222222
5=22222222222222222222
6=22222266666662222222
7=22222261166662222222
8=22222261117462222222
9=22222261156162222222
10=22222261145362222222
11=22222266666662222222
12=22222222222222222222
13=22222222222222222222
14=22222222222222222222
15=22222222222222222222
16=22222222222222222222
[16]
1=22222222222222222222
2=22222222222222222222
3=22222222222222222222
4=22222222222222222222
5=22222222222222222222
6=22222266666662222222
7=22222261141166222222
8=22222261556416222222
9=22222261635116222222
10=22222261146116222222
11=22222266666666222222
12=22222222222222222222
13=22222222222222222222
14=22222222222222222222
15=22222222222222222222
16=22222222222222222222
[17]
1=22222222222222222222
2=22222222222222222222
3=22222222222222222222
4=22222222222222222222
5=22222222222222222222
6=22222266666222222222
7=22222263116662222222
8=22222261555162222222
9=22222266144462222222
10=22222261116162222222
11=22222261111162222222
12=22222266666662222222
13=22222222222222222222
14=22222222222222222222
15=22222222222222222222
16=22222222222222222222
[18]
1=22222222222222222222
2=22222222222222222222
3=22222222222222222222
4=22222222222222222222
5=22222222222222222222
6=22222266666662222222
7=22222261166662222222
8=22222261116662222222
9=22222265153662222222
10=22222264165162222222
11=22222261141462222222
12=22222266666662222222
13=22222222222222222222
14=22222222222222222222
15=22222222222222222222
16=22222222222222222222
[19]
1=22222222222222222222
2=22222222222222222222
3=22222222222222222222
4=22222222222222222222
5=22222222222222222222
6=22222226666662222222
7=22222226311462222222
8=22222226555162222222
9=22222226416162222222
10=22222226114162222222
11=22222226666662222222
12=22222222222222222222
13=22222222222222222222
14=22222222222222222222
15=22222222222222222222
16=22222222222222222222
[20]
1=22222222222222222222
2=22222222222222222222
3=22222222222222222222
4=22222222222222222222
5=22222222222222222222
6=22222266666662222222
7=22222263111166222222
8=22222261616516222222
9=22222264157116222222
10=22222261116146222222
11=22222266666666222222
12=22222222222222222222
13=22222222222222222222
14=22222222222222222222
15=22222222222222222222
16=22222222222222222222
[21]
1=22222222222222222222
2=22222222222222222222
3=22222222222222222222
4=22222222222222222222
5=22222222222222222222
6=22222266666622222222
7=22222261113662222222
8=22222261167162222222
9=22222261115162222222
10=22222261154462222222
11=22222266666662222222
12=22222222222222222222
13=22222222222222222222
14=22222222222222222222
15=22222222222222222222
16=22222222222222222222
[22]
1=22222222222222222222
2=22222222222222222222
3=22222222222222222222
4=22222222222222222222
5=22222222222222222222
6=22222222266666222222
7=22222266661416222222
8=22222261351116222222
9=22222261117716222222
10=22222261111666222222
11=22222266666622222222
12=22222222222222222222
13=22222222222222222222
14=22222222222222222222
15=22222222222222222222
16=22222222222222222222
[23]
1=22222222222222222222
2=22222222222222222222
3=22222222222222222222
4=22222222222222222222
5=22222222222222222222
6=22222266666666222222
7=22222266114166222222
8=22222261115536222222
9=22222261641516222222
10=22222261146116222222
11=22222266666666222222
12=22222222222222222222
13=22222222222222222222
14=22222222222222222222
15=22222222222222222222
16=22222222222222222222
[24]
1=22222222222222222222
2=22222222222222222222
3=22222222222222222222
4=22222222222222222222
5=22222222222222222222
6=22222266666662222222
7=22222261141162222222
8=22222261516166222222
9=22222264651516222222
10=22222261146316222222
11=22222261116116222222
12=22222266666666222222
13=22222222222222222222
14=22222222222222222222
15=22222222222222222222
16=22222222222222222222
[25]
1=22222222222222222222
2=22222222222222222222
3=22222222222222222222
4=22222222222222222222
5=22222222222222222222
6=22222266666662222222
7=22222264116662222222
8=22222261615162222222
9=22222261171162222222
10=22222261166162222222
11=22222261711362222222
12=22222266666662222222
13=22222222222222222222
14=22222222222222222222
15=22222222222222222222
16=22222222222222222222
[26]
1=22222222222222222222
2=22222222222222222222
3=22222222222222222222
4=22222222222222222222
5=22222222222222222222
6=22222266666662222222
7=22222261111166222222
8=22222261636116222222
9=22222264555416222222
10=22222261116416222222
11=22222266666666222222
12=22222222222222222222
13=22222222222222222222
14=22222222222222222222
15=22222222222222222222
16=22222222222222222222
[27]
1=22222222222222222222
2=22222222222222222222
3=22222222222222222222
4=22222222222222222222
5=22222222222222222222
6=22222266666666222222
7=22222263466666222222
8=22222265511166222222
9=22222264516166222222
10=22222261141166222222
11=22222266666666222222
12=22222222222222222222
13=22222222222222222222
14=22222222222222222222
15=22222222222222222222
16=22222222222222222222
[28]
1=22222222222222222222
2=22222222222222222222
3=22222222222222222222
4=22222222222222222222
5=22222222222222222222
6=22222266666222222222
7=22222261116222222222
8=22222261616662222222
9=22222264155162222222
10=22222264116162222222
11=22222261173162222222
12=22222266666662222222
13=22222222222222222222
14=22222222222222222222
15=22222222222222222222
16=22222222222222222222
[29]
1=22222222222222222222
2=22222222222222222222
3=22222222222222222222
4=22222222222222222222
5=22222222222222222222
6=22222266666666222222
7=22222266411166222222
8=22222261155586222222
9=22222261616116222222
10=22222264111166222222
11=22222266666666222222
12=22222222222222222222
13=22222222222222222222
14=22222222222222222222
15=22222222222222222222
16=22222222222222222222
[30]
1=22222222222222222222
2=22222222222222222222
3=22222222222222222222
4=22222222222222222222
5=22222222222222222222
6=22222266666662222222
7=22222266411662222222
8=22222268555162222222
9=22222261611462222222
10=22222261111662222222
11=22222266666662222222
12=22222222222222222222
13=22222222222222222222
14=22222222222222222222
15=22222222222222222222
16=22222222222222222222
[31]
1=22222222222222222222
2=22222222222222222222
3=22222222222222222222
4=22222222222222222222
5=22222222222222222222
6=22222266666222222222
7=22222261116622222222
8=22222264111662222222
9=22222261645162222222
10=22222261556162222222
11=22222266141162222222
12=22222226666662222222
13=22222222222222222222
14=22222222222222222222
15=22222222222222222222
16=22222222222222222222
[32]
1=22222222222222222222
2=22222222222222222222
3=22222222222222222222
4=22222222222222222222
5=22222222222222222222
6=22222266666662222222
7=22222266111662222222
8=22222266164662222222
9=22222261154662222222
10=22222261615162222222
11=22222261171362222222
12=22222266666662222222
13=22222222222222222222
14=22222222222222222222
15=22222222222222222222
16=22222222222222222222
[33]
1=22222222222222222222
2=22222222222222222222
3=22222222222222222222
4=22222222222222222222
5=22222222222222222222
6=22222266666222222222
7=22222261116622222222
8=22222261651662222222
9=22222264171162222222
10=22222261561162222222
11=22222268171162222222
12=22222266666662222222
13=22222222222222222222
14=22222222222222222222
15=22222222222222222222
16=22222222222222222222
[34]
1=22222222222222222222
2=22222222222222222222
3=22222222222222222222
4=22222222222222222222
5=22222222222222222222
6=22222266666666222222
7=22222266316666222222
8=22222266551116222222
9=22222261151616222222
10=22222261614446222222
11=22222261116666222222
12=22222266666666222222
13=22222222222222222222
14=22222222222222222222
15=22222222222222222222
16=22222222222222222222
[35]
1=22222222222222222222
2=22222222222222222222
3=22222222222222222222
4=22222222222222222222
5=22222222222222222222
6=22222266666622222222
7=22222263171666222222
8=22222261611116222222
9=22222264554616222222
10=22222261111116222222
11=22222266666666222222
12=22222222222222222222
13=22222222222222222222
14=22222222222222222222
15=22222222222222222222
16=22222222222222222222
[36]
1=22222222222222222222
2=22222222222222222222
3=22222222222222222222
4=22222222222222222222
5=22222222222222222222
6=22222266666662222222
7=22222263144166222222
8=22222261516116222222
9=22222261655116222222
10=22222261116116222222
11=22222264116116222222
12=22222266666666222222
13=22222222222222222222
14=22222222222222222222
15=22222222222222222222
16=22222222222222222222
[37]
1=22222222222222222222
2=22222222222222222222
3=22222222222222222222
4=22222222222222222222
5=22222222222222222222
6=22222266666666222222
7=22222266145366222222
8=22222266175516222222
9=22222261411116222222
10=22222261616116222222
11=22222261146666222222
12=22222266666666222222
13=22222222222222222222
14=22222222222222222222
15=22222222222222222222
16=22222222222222222222
[38]
1=22222222222222222222
2=22222222222222222222
3=22222222222222222222
4=22222222222222222222
5=22222222222222222222
6=22222266666222222222
7=22222264146666222222
8=22222265511116222222
9=22222263561116222222
10=22222261411116222222
11=22222266666666222222
12=22222222222222222222
13=22222222222222222222
14=22222222222222222222
15=22222222222222222222
16=22222222222222222222
[39]
1=22222222222222222222
2=22222222222222222222
3=22222222222222222222
4=22222222222222222222
5=22222222222222222222
6=22222666666222222222
7=22222611116222222222
8=22222616616622222222
9=22222614171666222222
10=22222661517116222222
11=22222261161136222222
12=22222266666666222222
13=22222222222222222222
14=22222222222222222222
15=22222222222222222222
16=22222222222222222222
[40]
1=22222222222222222222
2=22222222222222222222
3=22222222222222222222
4=22222222222222222222
5=22222222222222222222
6=22222266666622222222
7=22222261111666222222
8=22222261365116222222
9=22222261745116222222
10=22222261416116222222
11=22222266666666222222
12=22222222222222222222
13=22222222222222222222
14=22222222222222222222
15=22222222222222222222
16=22222222222222222222
[41]
1=22222222222222222222
2=22222222222222222222
3=22222222222222222222
4=22222222222222222222
5=22222222222222222222
6=22222666666222222222
7=22222611116222222222
8=22222616616622222222
9=22222614534666222222
10=22222661551116222222
11=22222261164116222222
12=22222266666666222222
13=22222222222222222222
14=22222222222222222222
15=22222222222222222222
16=22222222222222222222
[42]
1=22222222222222222222
2=22222222222222222222
3=22222222222222222222
4=22222222222222222222
5=22222222222222222222
6=22222266666666222222
7=22222261451666222222
8=22222261115866222222
9=22222265116166222222
10=22222264145166222222
11=22222266666666222222
12=22222222222222222222
13=22222222222222222222
14=22222222222222222222
15=22222222222222222222
16=22222222222222222222
[43]
1=22222222222222222222
2=22222222222222222222
3=22222222222222222222
4=22222222222222222222
5=22222222222222222222
6=22222266666662222222
7=22222266661362222222
8=22222266455462222222
9=22222261151662222222
10=22222261614662222222
11=22222261514662222222
12=22222266666662222222
13=22222222222222222222
14=22222222222222222222
15=22222222222222222222
16=22222222222222222222
[44]
1=22222222222222222222
2=22222222222222222222
3=22222222222222222222
4=22222222222222222222
5=22222222222222222222
6=22222266666662222222
7=22222266681662222222
8=22222261155162222222
9=22222261651162222222
10=22222264111462222222
11=22222266666662222222
12=22222222222222222222
13=22222222222222222222
14=22222222222222222222
15=22222222222222222222
16=22222222222222222222
[45]
1=22222222222222222222
2=22222222222222222222
3=22222222222222222222
4=22222222222222222222
5=22222222222222222222
6=22222266666622222222
7=22222263146666222222
8=22222261715116222222
9=22222261561616222222
10=22222261114116222222
11=22222266666666222222
12=22222222222222222222
13=22222222222222222222
14=22222222222222222222
15=22222222222222222222
16=22222222222222222222
[46]
1=22222222222222222222
2=22222222222222222222
3=22222222222222222222
4=22222222222222222222
5=22222222222222222222
6=22222266666662222222
7=22222266116662222222
8=22222266145162222222
9=22222261551162222222
10=22222261641462222222
11=22222263116662222222
12=22222266666662222222
13=22222222222222222222
14=22222222222222222222
15=22222222222222222222
16=22222222222222222222
[47]
1=22222222222222222222
2=22222222222222222222
3=22222222222222222222
4=22222222222222222222
5=22222222222222222222
6=22222666666222222222
7=22222611116222222222
8=22222616676622222222
9=22222611171666222222
10=22222661115116222222
11=22222261364116222222
12=22222266666666222222
13=22222222222222222222
14=22222222222222222222
15=22222222222222222222
16=22222222222222222222
[48]
1=22222222222222222222
2=22222222222222222222
3=22222222222222222222
4=22222222222222222222
5=22222222222222222222
6=22222266666662222222
7=22222263711662222222
8=22222265551162222222
9=22222264116162222222
10=22222261114462222222
11=22222266666662222222
12=22222222222222222222
13=22222222222222222222
14=22222222222222222222
15=22222222222222222222
16=22222222222222222222
[49]
1=22222222222222222222
2=22222222222222222222
3=22222222222222222222
4=22222222222222222222
5=22222222222222222222
6=22222266666666222222
7=22222266311666222222
8=22222264575116222222
9=22222261611146222222
10=22222261111666222222
11=22222266666666222222
12=22222222222222222222
13=22222222222222222222
14=22222222222222222222
15=22222222222222222222
16=22222222222222222222
[50]
1=22222222222222222222
2=22222222222222222222
3=22222222222222222222
4=22222222222222222222
5=22222222222222222222
6=22222226666622222222
7=22222266111622222222
8=22222661411666222222
9=22222635555116222222
10=22222616416616222222
11=22222611414116222222
12=22222666666666222222
13=22222222222222222222
14=22222222222222222222
15=22222222222222222222
16=22222222222222222222
[51]
1=22222222222222222222
2=22222222222222222222
3=22222222222222222222
4=22222222222222222222
5=22222222222222222222
6=22222266666666222222
7=22222266116666222222
8=22222266171416222222
9=22222261511616222222
10=22222261615116222222
11=22222263146666222222
12=22222266666666222222
13=22222222222222222222
14=22222222222222222222
15=22222222222222222222
16=22222222222222222222
[52]
1=22222222222222222222
2=22222222222222222222
3=22222222222222222222
4=22222222222222222222
5=22222222222222222222
6=22222226666622222222
7=22222266311662222222
8=22222261575162222222
9=22222264116162222222
10=22222261641162222222
11=22222261111662222222
12=22222266666622222222
13=22222222222222222222
14=22222222222222222222
15=22222222222222222222
16=22222222222222222222
[53]
1=22222222222222222222
2=22222222222222222222
3=22222222222222222222
4=22222222222222222222
5=22222222222222222222
6=22222266666666222222
7=22222266116666222222
8=22222268111666222222
9=22222261651116222222
10=22222261155116222222
11=22222266414666222222
12=22222266666666222222
13=22222222222222222222
14=22222222222222222222
15=22222222222222222222
16=22222222222222222222
[54]
1=22222222222222222222
2=22222222222222222222
3=22222222222222222222
4=22222222222222222222
5=22222222222222222222
6=22222666666222222222
7=22222611116222222222
8=22222616616622222222
9=22222611741666222222
10=22222665115116222222
11=22222264161136222222
12=22222266666666222222
13=22222222222222222222
14=22222222222222222222
15=22222222222222222222
16=22222222222222222222
[55]
1=22222222222222222222
2=22222222222222222222
3=22222222222222222222
4=22222222222222222222
5=22222222222222222222
6=22222266666662222222
7=22222266114662222222
8=22222266165662222222
9=22222261511662222222
10=22222261615462222222
11=22222261411362222222
12=22222266666662222222
13=22222222222222222222
14=22222222222222222222
15=22222222222222222222
16=22222222222222222222
[56]
1=22222222222222222222
2=22222222222222222222
3=22222222222222222222
4=22222222222222222222
5=22222222222222222222
6=22222266666662222222
7=22222261453662222222
8=22222261455462222222
9=22222265116162222222
10=22222264111162222222
11=22222266666662222222
12=22222222222222222222
13=22222222222222222222
14=22222222222222222222
15=22222222222222222222
16=22222222222222222222
[57]
1=22222222222222222222
2=22222222222222222222
3=22222222222222222222
4=22222222222222222222
5=22222222222222222222
6=22222266666666222222
7=22222266416666222222
8=22222266451146222222
9=22222264511616222222
10=22222261655116222222
11=22222263116666222222
12=22222266666666222222
13=22222222222222222222
14=22222222222222222222
15=22222222222222222222
16=22222222222222222222
[58]
1=22222222222222222222
2=22222222222222222222
3=22222222222222222222
4=22222222222222222222
5=22222266666622222222
6=22222266611662222222
7=22222266611166222222
8=22222266651116222222
9=22222266614616222222
10=22222261754136222222
11=22222261111666222222
12=22222266666666222222
13=22222222222222222222
14=22222222222222222222
15=22222222222222222222
16=22222222222222222222
[59]
1=22222222222222222222
2=22222222222222222222
3=22222222222222222222
4=22222222222222222222
5=22222222222222222222
6=22222266666662222222
7=22222266411662222222
8=22222267461662222222
9=22222264515162222222
10=22222265116162222222
11=22222261117362222222
12=22222266666662222222
13=22222222222222222222
14=22222222222222222222
15=22222222222222222222
16=22222222222222222222
[60]
1=22222222222222222222
2=22222222222222222222
3=22222222222222222222
4=22222222222222222222
5=22222222222222222222
6=22222266666662222222
7=22222266116662222222
8=22222266541162222222
9=22222261111162222222
10=22222261677162222222
11=22222263116662222222
12=22222266666662222222
13=22222222222222222222
14=22222222222222222222
15=22222222222222222222
16=22222222222222222222
[61]
1=22222222222222222222
2=22222222222222222222
3=22222222222222222222
4=22222222222222222222
5=22222222222222222222
6=22222266666622222222
7=22222261146666222222
8=22222261415116222222
9=22222261165616222222
10=22222261114536222222
11=22222266666666222222
12=22222222222222222222
13=22222222222222222222
14=22222222222222222222
15=22222222222222222222
16=22222222222222222222
[62]
1=22222222222222222222
2=22222222222222222222
3=22222222222222222222
4=22222222222222222222
5=22222222222222222222
6=22222266666662222222
7=22222261543662222222
8=22222261151162222222
9=22222261156162222222
10=22222261474162222222
11=22222266666662222222
12=22222222222222222222
13=22222222222222222222
14=22222222222222222222
15=22222222222222222222
16=22222222222222222222
[63]
1=22222222222222222222
2=22222222222222222222
3=22222222222222222222
4=22222222222222222222
5=22222222222222222222
6=22222266666622222222
7=22222264441666222222
8=22222261365116222222
9=22222261515116222222
10=22222261116116222222
11=22222266666666222222
12=22222222222222222222
13=22222222222222222222
14=22222222222222222222
15=22222222222222222222
16=22222222222222222222
[64]
1=22222222222222222222
2=22222222222222222222
3=22222222222222222222
4=22222222222222222222
5=22222222222222222222
6=22222666666622222222
7=22222611141662222222
8=22222616611166222222
9=22222611576116222222
10=22222665111116222222
11=22222261461136222222
12=22222266666666222222
13=22222222222222222222
14=22222222222222222222
15=22222222222222222222
16=22222222222222222222
[65]
1=22222222222222222222
2=22222222222222222222
3=22222222222222222222
4=22222222222222222222
5=22222266666666222222
6=22222266611666222222
7=22222266611166222222
8=22222266645116222222
9=22222266641616222222
10=22222261155116222222
11=22222261186666222222
12=22222266666666222222
13=22222222222222222222
14=22222222222222222222
15=22222222222222222222
16=22222222222222222222
[66]
1=22222222222222222222
2=22222222222222222222
3=22222222222222222222
4=22222222222222222222
5=22222222222222222222
6=22222666666222222222
7=22222611146222222222
8=22222616656622222222
9=22222615111666222222
10=22222616511746222222
11=22222641361116222222
12=22222666666666222222
13=22222222222222222222
14=22222222222222222222
15=22222222222222222222
16=22222222222222222222
[67]
1=22222222222222222222
2=22222222222222222222
3=22222222222222222222
4=22222222222222222222
5=22222222222222222222
6=22222666666222222222
7=22222645446662222222
8=22222616615166222222
9=22222611151546222222
10=22222611611516222222
11=22222611146136222222
12=22222666666666222222
13=22222222222222222222
14=22222222222222222222
15=22222222222222222222
16=22222222222222222222
[68]
1=22222222222222222222
2=22222222222222222222
3=22222222222222222222
4=22222222222222222222
5=22222222222222222222
6=22222222666622222222
7=22222266611666222222
8=22222261141416222222
9=22222261645616222222
10=22222263511516222222
11=22222266611666222222
12=22222222666622222222
13=22222222222222222222
14=22222222222222222222
15=22222222222222222222
16=22222222222222222222
[69]
1=22222222222222222222
2=22222222222222222222
3=22222222222222222222
4=22222222222222222222
5=22222222222222222222
6=22222226666622222222
7=22222226311622222222
8=22222666161666222222
9=22222611457516222222
10=22222616111616222222
11=22222611461116222222
12=22222666666666222222
13=22222222222222222222
14=22222222222222222222
15=22222222222222222222
16=22222222222222222222
[70]
1=22222222222222222222
2=22222222222222222222
3=22222222222222222222
4=22222222222222222222
5=22222222222222222222
6=22222266666662222222
7=22222266116662222222
8=22222266111162222222
9=22222261541462222222
10=22222261655162222222
11=22222263146662222222
12=22222266666662222222
13=22222222222222222222
14=22222222222222222222
15=22222222222222222222
16=22222222222222222222
[71]
1=22222222222222222222
2=22222222222222222222
3=22222222222222222222
4=22222222222222222222
5=22222222222222222222
6=22222266666666222222
7=22222266314666222222
8=22222261555116222222
9=22222261641116222222
10=22222261411666222222
11=22222266666666222222
12=22222222222222222222
13=22222222222222222222
14=22222222222222222222
15=22222222222222222222
16=22222222222222222222
[72]
1=22222222222222222222
2=22222222222222222222
3=22222222222222222222
4=22222222222222222222
5=22222266666666222222
6=22222266611166222222
7=22222266611166222222
8=22222266615116222222
9=22222266654616222222
10=22222261157116222222
11=22222264413666222222
12=22222266666666222222
13=22222222222222222222
14=22222222222222222222
15=22222222222222222222
16=22222222222222222222
[73]
1=22222222222222222222
2=22222222222222222222
3=22222222222222222222
4=22222222222222222222
5=22222222222222222222
6=22222226666622222222
7=22222226111662222222
8=22222266414166622222
9=22222263517151622222
10=22222261611661622222
11=22222261171111622222
12=22222266666666622222
13=22222222222222222222
14=22222222222222222222
15=22222222222222222222
16=22222222222222222222
[74]
1=22222222222222222222
2=22222222222222222222
3=22222222222222222222
4=22222222222222222222
5=22222222222222222222
6=22222222666662222222
7=22222222631162222222
8=22222226656566622222
9=22222226141411622222
10=22222226161151622222
11=22222226114166622222
12=22222226666662222222
13=22222222222222222222
14=22222222222222222222
15=22222222222222222222
16=22222222222222222222
[75]
1=22222222222222222222
2=22222222222222222222
3=22222222222222222222
4=22222222222222222222
5=22222226666666622222
6=22222226661186622222
7=22222226661556622222
8=22222226665111622222
9=22222226661461622222
10=22222226141711622222
11=22222226115466622222
12=22222226666666622222
13=22222222222222222222
14=22222222222222222222
15=22222222222222222222
16=22222222222222222222
[76]
1=22222222222222222222
2=22222222222222222222
3=22222222222222222222
4=22222222222222222222
5=22222266666666622222
6=22222266111666622222
7=22222266164141622222
8=22222264751164622222
9=22222264511511622222
10=22222265566111622222
11=22222263166666622222
12=22222266666666622222
13=22222222222222222222
14=22222222222222222222
15=22222222222222222222
16=22222222222222222222
[77]
1=22222222222222222222
2=22222222222222222222
3=22222222222222222222
4=22222222222222222222
5=22222222266666622222
6=22222222264111622222
7=22222222261111622222
8=22222226665146622222
9=22222226111646222222
10=22222226155546222222
11=22222226314516222222
12=22222226666666222222
13=22222222222222222222
14=22222222222222222222
15=22222222222222222222
16=22222222222222222222
[78]
1=22222222222222222222
2=22222222222222222222
3=22222222222222222222
4=22222222222222222222
5=22222226666666622222
6=22222226411111622222
7=22222226166161622222
8=22222226173711622222
9=22222226655466622222
10=22222222611116222222
11=22222222645116222222
12=22222222666666222222
13=22222222222222222222
14=22222222222222222222
15=22222222222222222222
16=22222222222222222222
